Code	Language
swe	Swedish
nob	Norwegian bokm√•l
nno	Norwegien nynorsk
dan	Danish
ice	Icelandic
fin	Finnish
eng	English
ger	German
fre	French
spa	Spanish
por	Portuguese
dut	Dutch
gre	Greek
rus	Russian
cze	Czech
chi	Chinese
jap	Japanese
kor	Korean
tha	Thai
swa	Swahili
ara	Arabic
